MAZEGAME_SAVE_V1
2
110
54
8 8
##########
#        #
#  ##  # #
#  #  ## #
#   ##   #
#    #   #
#  #     #
# # #    #
##  #   E#
##########
8 8
