MAZEGAME_SAVE_V1
1
20
26
8 8
##########
#   #    #
# # # ## #
# #    # #
# #### # #
#      # #
### # ## #
#   #    #
# ######E#
##########
8 8
